#separator:tab
#html:false
[...] chien aime jouer. (El perro le gusta jugar.)	Le chien aime jouer. (El perro le gusta jugar.)
[...] maison est grande. (La casa es grande.)	La maison est grande. (La casa es grande.)
[...]hôtel est cher. (El hotel es caro.)	L'hôtel est cher. (El hotel es caro.)
[...] fleurs sont belles. (Las flores son bonitas.)	Les fleurs sont belles. (Las flores son bonitas.)
J'ai [...] chat noir. (Tengo un gato negro.)	J'ai un chat noir. (Tengo un gato negro.)
Elle achète [...] robe. (Ella compra un vestido.)	Elle achète une robe. (Ella compra un vestido.)
Il y a [...] enfants dans le parc. (Hay niños en el parque.)	Il y a des enfants dans le parc. (Hay niños en el parque.)
Je viens [...] Madrid. (Vengo de Madrid.)	Je viens de Madrid. (Vengo de Madrid.)
Il va [...] l'école. (Él va a la escuela.)	Il va à l'école. (Él va a la escuela.)
Nous vivons [...] Espagne. (Vivimos en España.)	Nous vivons en Espagne. (Vivimos en España.)
C'est [...] ma mère. (Es para mi madre.)	C'est pour ma mère. (Es para mi madre.)
Je sors [...] mes amis. (Salgo con mis amigos.)	Je sors avec mes amis. (Salgo con mis amigos.)
Une pizza [...] fromage. (Una pizza sin queso.)	Une pizza sans fromage. (Una pizza sin queso.)
Le livre est [...] l'étagère. (El libro está sobre el estante.)	Le livre est sur l'étagère. (El libro está sobre el estante.)
Les clés sont [...] mon sac. (Las llaves están en mi bolso.)	Les clés sont dans mon sac. (Las llaves están en mi bolso.)
Paul [...] Marie sont mariés. (Paul y Marie están casados.)	Paul et Marie sont mariés. (Paul y Marie están casados.)
Café [...] thé ? (¿Café o té?)	Café ou thé ? (¿Café o té?)
Il est riche [...] avare. (Es rico pero avaro.)	Il est riche mais avare. (Es rico pero avaro.)
[...] mange du pain. (Yo como pan.)	Je mange du pain. (Yo como pan.)
[...] écoutes de la musique. (Tú escuchas música.)	Tu écoutes de la musique. (Tú escuchas música.)
[...] travaille beaucoup. (Él trabaja mucho.)	Il travaille beaucoup. (Él trabaja mucho.)
[...] danse bien. (Ella baila bien.)	Elle danse bien. (Ella baila bien.)
[...] fait froid aujourd'hui. (Hace frío hoy.)	On fait froid aujourd'hui. (Hace frío hoy.)
[...] parlons français. (Nosotros hablamos francés.)	Nous parlons français. (Nosotros hablamos francés.)
[...] habitez en ville. (Ustedes viven en la ciudad.)	Vous habitez en ville. (Ustedes viven en la ciudad.)
[...] mangent au restaurant. (Ellos comen en el restaurante.)	Ils mangent au restaurant. (Ellos comen en el restaurante.)
[...] étudient la médecine. (Ellas estudian medicina.)	Elles étudient la médecine. (Ellas estudian medicina.)
[...] suis professeur. (Yo soy profesor.)	Je suis professeur. (Yo soy profesor.)
[...] es français ? (¿Tú eres francés?)	Tu es français ? (¿Tú eres francés?)
[...] est médecin. (Él es médico.)	Il est médecin. (Él es médico.)
[...] est avocate. (Ella es abogada.)	Elle est avocate. (Ella es abogada.)
[...] est dimanche. (Es domingo.)	On est dimanche. (Es domingo.)
[...] sommes en vacances. (Estamos de vacaciones.)	Nous sommes en vacances. (Estamos de vacaciones.)
[...] êtes très gentils. (Ustedes son muy amables.)	Vous êtes très gentils. (Ustedes son muy amables.)
[...] sont en retard. (Ellos llegan tarde.)	Ils sont en retard. (Ellos llegan tarde.)
[...] sont professeurs. (Ellas son profesoras.)	Elles sont professeurs. (Ellas son profesoras.)
[...] ai vingt ans. (Tengo veinte años.)	J'ai vingt ans. (Tengo veinte años.)
[...] as une soeur ? (¿Tienes una hermana?)	Tu as une soeur ? (¿Tienes una hermana?)
[...] a trois enfants. (Él tiene tres hijos.)	Il a trois enfants. (Él tiene tres hijos.)
[...] a les yeux bleus. (Ella tiene los ojos azules.)	Elle a les yeux bleus. (Ella tiene los ojos azules.)
[...] a de la chance. (Tenemos suerte.)	On a de la chance. (Tenemos suerte.)
[...] avons une grande famille. (Tenemos una familia grande.)	Nous avons une grande famille. (Tenemos una familia grande.)
[...] avez raison. (Ustedes tienen razón.)	Vous avez raison. (Ustedes tienen razón.)
[...] ont une belle maison. (Ellos tienen una casa bonita.)	Ils ont une belle maison. (Ellos tienen una casa bonita.)
[...] ont du travail. (Ellas tienen trabajo.)	Elles ont du travail. (Ellas tienen trabajo.)
J'ai [...] stylo rouge. (Tengo un bolígrafo rojo.)	J'ai un stylo rouge. (Tengo un bolígrafo rojo.)
[...] voiture est bleue. (El coche es azul.)	La voiture est bleue. (El coche es azul.)
Elle mange [...] pomme. (Ella come una manzana.)	Elle mange une pomme. (Ella come una manzana.)
[...]ami de Paul est sympa. (El amigo de Paul es simpático.)	L'ami de Paul est sympa. (El amigo de Paul es simpático.)
Ce sont [...] chaises. (Son sillas.)	Ce sont des chaises. (Son sillas.)
J'aime [...] chiens. (Me gustan los perros.)	J'aime les chiens. (Me gustan los perros.)
Un homme et [...] femme. (Un hombre y una mujer.)	Un homme et une femme. (Un hombre y una mujer.)
[...] homme et une femme. (Un hombre y una mujer.)	Un homme et une femme. (Un hombre y una mujer.)
[...]eau est froide. (El agua está fría.)	L'eau est froide. (El agua está fría.)
[...] enfants jouent. (Los niños juegan.)	Les enfants jouent. (Los niños juegan.)
Le chat est [...] la table. (El gato está sobre la mesa.)	Le chat est sur la table. (El gato está sobre la mesa.)
Je vais [...] Paris. (Voy a París.)	Je vais à Paris. (Voy a París.)
Le livre est [...] le sac. (El libro está en la bolsa.)	Le livre est dans le sac. (El libro está en la bolsa.)
C'est un cadeau [...] toi. (Es un regalo para ti.)	C'est un cadeau pour toi. (Es un regalo para ti.)
Il parle [...] son ami. (Él habla con su amigo.)	Il parle avec son ami. (Él habla con su amigo.)
Un café [...] sucre. (Un café sin azúcar.)	Un café sans sucre. (Un café sin azúcar.)
Je suis [...] France. (Estoy en Francia.)	Je suis en France. (Estoy en Francia.)
Le stylo [...] Marie. (El bolígrafo de María.)	Le stylo de Marie. (El bolígrafo de María.)
Je travaille [...] apprendre. (Trabajo para aprender.)	Je travaille pour apprendre. (Trabajo para aprender.)
Elle voyage [...] train. (Ella viaja en tren.)	Elle voyage en train. (Ella viaja en tren.)
J'aime le chocolat [...] la vanille. (Me gusta el chocolate y la vainilla.)	J'aime le chocolat et la vanille. (Me gusta el chocolate y la vainilla.)
Tu veux du thé [...] du café ? (¿Quieres té o café?)	Tu veux du thé ou du café ? (¿Quieres té o café?)
Il est petit [...] fort. (Es pequeño pero fuerte.)	Il est petit mais fort. (Es pequeño pero fuerte.)
Chien [...] chat. (Perro y gato.)	Chien et chat. (Perro y gato.)
Rouge [...] bleu ? (¿Rojo o azul?)	Rouge ou bleu ? (¿Rojo o azul?)
[...] parle français. (Yo hablo francés.)	Je parle français. (Yo hablo francés.)
[...] manges une pomme. (Tú comes una manzana.)	Tu manges une pomme. (Tú comes una manzana.)
[...] est grand. (Él es alto.)	Il est grand. (Él es alto.)
[...] a un chat. (Ella tiene un gato.)	Elle a un chat. (Ella tiene un gato.)
En France, [...] mange bien. (En Francia, se come bien / comemos bien.)	En France, on mange bien. (En Francia, se come bien / comemos bien.)
[...] sommes amis. (Nosotros somos amigos.)	Nous sommes amis. (Nosotros somos amigos.)
[...] avez un livre. (Usted tiene / Ustedes tienen / Vosotros tenéis un libro.)	Vous avez un livre. (Usted tiene / Ustedes tienen / Vosotros tenéis un libro.)
[...] regardent la télé. (Ellos ven la tele.)	Ils regardent la télé. (Ellos ven la tele.)
[...] parlent espagnol. (Ellas hablan español.)	Elles parlent espagnol. (Ellas hablan español.)
[...]aime Paris. (Me gusta París.)	J'aime Paris. (Me gusta París.)
Je [...] content. (Yo estoy contento.)	Je suis content. (Yo estoy contento.)
Tu [...] étudiant ? (¿Tú eres estudiante?)	Tu es étudiant ? (¿Tú eres estudiante?)
Marie [...] intelligente. (María es inteligente.)	Marie est intelligente. (María es inteligente.)
Nous [...] à la maison. (Nosotros estamos en casa.)	Nous sommes à la maison. (Nosotros estamos en casa.)
Vous [...] fatigué. (Usted está cansado / Ustedes están cansados / Vosotros estáis cansados.)	Vous êtes fatigué. (Usted está cansado / Ustedes están cansados / Vosotros estáis cansados.)
Ils [...] grands. (Ellos son altos.)	Ils sont grands. (Ellos son altos.)
Elle [...] espagnole. (Ella es española.)	Elle est espagnole. (Ella es española.)
On [...] samedi. (Es sábado / Estamos a sábado.)	On est samedi. (Es sábado / Estamos a sábado.)
Les enfants [...] ici. (Los niños están aquí.)	Les enfants sont ici. (Los niños están aquí.)
Je ne [...] pas triste. (No estoy triste.)	Je ne suis pas triste. (No estoy triste.)
J'[...] un frère. (Yo tengo un hermano.)	J'ai un frère. (Yo tengo un hermano.)
Tu [...] quel âge ? (¿Qué edad tienes tú?)	Tu as quel âge ? (¿Qué edad tienes tú?)
Il [...] une voiture rouge. (Él tiene un coche rojo.)	Il a une voiture rouge. (Él tiene un coche rojo.)
Elle [...] faim. (Ella tiene hambre.)	Elle a faim. (Ella tiene hambre.)
On [...] soif. (Tenemos sed / Uno tiene sed.)	On a soif. (Tenemos sed / Uno tiene sed.)
Nous [...] des amis. (Nosotros tenemos amigos.)	Nous avons des amis. (Nosotros tenemos amigos.)
Vous [...] l'heure ? (¿Usted tiene la hora? / ¿Ustedes tienen la hora? / ¿Vosotros tenéis la hora?)	Vous avez l'heure ? (¿Usted tiene la hora? / ¿Ustedes tienen la hora? / ¿Vosotros tenéis la hora?)
Ils [...] deux chiens. (Ellos tienen dos perros.)	Ils ont deux chiens. (Ellos tienen dos perros.)
Elles [...] des stylos. (Ellas tienen bolígrafos.)	Elles ont des stylos. (Ellas tienen bolígrafos.)
Tu n'[...] pas de soeur ? (¿No tienes hermana?)	Tu n'as pas de soeur ? (¿No tienes hermana?)
